+++++++++++++++++++++++++++++++++++++++++++++++++++++++++++++
+                             +                             +
+                             +                             +
+                             +                             +
+                             +                             +
+                             +                             +
+                             +                             +
+                             +                             +
+                             +                             +
+        +   +                +                +   +        +
+        +   +                +                +   +        +
+        + 1 +                +                + 2 +        +
+        +++++                +                +++++        +
+                             +                             +
+                             +                             +
+                             +                             +
+                             +                             +
+                             +                             +
+                             +                             +
+                             +                             +
+                             +                             +
+                             +                             +
+                             +                             +
+                             +                             +
+++++++++++++++++++++++++++++++++++++++++++++++++++++++++++++
