+++++++++++++++++++++++++++++++++++++++++++++++++++++++++++++
+                             +                             +
+                             +                             +
+                             +                             +
+                             +                             +
+                             +                             +
+                             +                             +
+                             +                             +
+                             +                             +
+                             +                             +
+                             +                             +
+++++++++++++++++++++++++++++++++++++++++++++ +++++++++++++++
+                             +                             +
+                             +                             +
+                             +                             +
+                             +                             +
+                             +                             +
+                             +                             +
+                             +                             +
+                             +                             +
+                             +                             +
+                             +                             +
+                             +                             +
+                             +                             +
+++++++++++++++++++++++++++++++++++++++++++++++++++++++++++++