+++++++++++++++++++++++++++++++++++++++++++++++++++++++++++++
+                             +                             +
+                             +                             +
+                             +                             +
+                             +          +++++++++++        +
+                      1      +                    +        +
+   +++++++++++++++++++++++++++                    +        +
+          +                  +                    +        +
+          +                  +                    +        +
+          +                  +                    +        +
+          +                  +                    +        +
+          +                  ++++++++++++++++++++++        +
+          +                  +                             +
+          +                  +                             +
+          +        +         +                             +
+          +        +         +                             +
+                   +         +       +++++++++++++++++++++++
+                   +         +       +                     +
+                   +         +       +                     +
+                   +         +       +            +        +
+++++++++++++++++++++         +       +            +        +
+                             +       +            +    2   +
+                             +                    +        +
+                             +                    +        +
+++++++++++++++++++++++++++++++++++++++++++++++++++++++++++++
