+++++++++++++++++++++++++++++++++++++++++++++++++++++++++++++
+                             +                             +
+                             +                             +
+                             +                             +
+                             +                             +
+                             +                             +
+                             +                             +
+                             +                             +
+                             +                             +
+     +   +                   +                +   +        +
+     +   +                   +                +   +        +
+     + 1 +                   +                + 2 +        +
+     +++++                   +                +++++        +
+                             +                             +
+                             +                             +
+                             +                             +
+                             +                             +
+                             +                             +
+                             +                             +
+                             +                             +
+                             +                             +
+                             +                             +
+                             +                             +
+                             +                             +
+++++++++++++++++++++++++++++++++++++++++++++++++++++++++++++
