+++++++++++++++++++++++++++++1+2+++++++++++++++++++++++++++++
+                      +    + + +    +                      +
+   ++++++++++++++++++ +    + + +    + ++++++++++++++++++   +
+  +                 + +    + + +    + +                 +  +
+ +                  + +    + + +    + +                  + +
+  +                 + ++++++ + ++++++ +                 +  +
+   +                         +                         +   +
+    +                        +                        +    +
+     +                       +                       +     +
+      +                      +                      +      +
+       +                     +                     +       +
+        +                    +                    +        +
+         +                   +                   +         +
+          +                  +                  +          +
+           +                 +                 +           +
+            +                +                +            +
+             +               +               +             +
+              +              +              +              +
+               +             +             +               +
+                +            +            +                +
+                 +           +           +                 +
+                  +          +          +                  +
+                   +         +         +                   +
+                    +        +        +                    +
+++++++++++++++++++++++++++++++++++++++++++++++++++++++++++++

