+++++++++++++++++++++++++++++++++++++++++++++++++++++++++++++
+                             +                             +
+                             +                             +
+                             +                             +
+                             +                             +
+                             +                             +
+                             +        ++++++++++++         +
+                             +                             +
+                             +                             +
+          +++++++            +                             +
+                +            +                             +
+                +            +                             +
+                +            +                             +
+                +            +                             +
+                ++++++++++++++++++++++                     +
+                             +       +                     +
+                             +     2 +                     +
+                             +    ++++                     +
+                             +                             +
+                             +                             +
+                     +       +                             +
+                     +   1   +                             +
+                     +       +                             +
+                     +       +                             +
+++++++++++++++++++++++++++++++++++++++++++++++++++++++++++++
