  _______    _             _       _            
 |__   __|  | |           (_)     | |     /\    
    | |_   _| |_ ___  _ __ _  __ _| |    /  \   
    | | | | | __/ _ \| '__| |/ _` | |   / /\ \  
    | | |_| | || (_) | |  | | (_| | |  / ____ \ 
    |_|\__,_|\__\___/|_|  |_|\__,_|_| /_/    \_\
                                                
                                                