  _                    _   ______               
 | |                  | | |  ____|              
 | |     _____   _____| | | |__ ___  _   _ _ __ 
 | |    / _ \ \ / / _ \ | |  __/ _ \| | | | '__|
 | |___|  __/\ V /  __/ | | | | (_) | |_| | |   
 |______\___| \_/ \___|_| |_|  \___/ \__,_|_|   
                                                
                                                