  _                    _   _______ _                   
 | |                  | | |__   __| |                  
 | |     _____   _____| |    | |  | |__  _ __ ___  ___ 
 | |    / _ \ \ / / _ \ |    | |  | '_ \| '__/ _ \/ _ \
 | |___|  __/\ V /  __/ |    | |  | | | | | |  __/  __/
 |______\___| \_/ \___|_|    |_|  |_| |_|_|  \___|\___|
                                                       
                                                       