  _______    _             _       _   ____  
 |__   __|  | |           (_)     | | |  _ \ 
    | |_   _| |_ ___  _ __ _  __ _| | | |_) |
    | | | | | __/ _ \| '__| |/ _` | | |  _ < 
    | | |_| | || (_) | |  | | (_| | | | |_) |
    |_|\__,_|\__\___/|_|  |_|\__,_|_| |____/ 
                                             
                                             