  _                    _   _______            
 | |                  | | |__   __|           
 | |     _____   _____| |    | |_      _____  
 | |    / _ \ \ / / _ \ |    | \ \ /\ / / _ \ 
 | |___|  __/\ V /  __/ |    | |\ V  V / (_) |
 |______\___| \_/ \___|_|    |_| \_/\_/ \___/ 
                                              
                                              