  _                    _    ____             
 | |                  | |  / __ \            
 | |     _____   _____| | | |  | |_ __   ___ 
 | |    / _ \ \ / / _ \ | | |  | | '_ \ / _ \
 | |___|  __/\ V /  __/ | | |__| | | | |  __/
 |______\___| \_/ \___|_|  \____/|_| |_|\___|
                                             
                                             