   _____                     _   ______ _             _      
  / ____|                   | | |  ____(_)           | |     
 | |  __ _ __ __ _ _ __   __| | | |__   _ _ __   __ _| | ___ 
 | | |_ | '__/ _` | '_ \ / _` | |  __| | | '_ \ / _` | |/ _ \
 | |__| | | | (_| | | | | (_| | | |    | | | | | (_| | |  __/
  \_____|_|  \__,_|_| |_|\__,_| |_|    |_|_| |_|\__,_|_|\___|
                                                             
                                                             