+++++++++++++++++++++++++++++++++++++++++++++++++++++++++++++
+                             +                             +
+                             +                             +
+                             +                             +
+                             +                             +
+                             +                             +
+              Y              +                             +
+                             +                             +
+                             +                             +
+                             +                             +
+                             +                             +
+                             +                             +
+ + + + + + + + + + + + + + + + + + + + + + + + + + + + + + +
+                             +                             +
+                             +                             +
+                             +                             +
+                             +                             +
+                             +                             +
+                             +               X             +
+                             +                             +
+                             +                             +
+                             +                             +
+                             +                             +
+                             +                             +
+++++++++++++++++++++++++++++++++++++++++++++++++++++++++++++
