+++++++++++++++++++++++++++++++++++++++++++++++++++++++++++++
+                             +                             +
+                             +                             +
+                             +                             +
+                             +                             +
+                             +                             +
+                             +                             +
+                             +                             +
+                             +                             +
+                             +                             +
+                             +                             +
+                             +                             +
+++++++++++++++ ++++++++++++++++++++++++++++++ ++++++++++++++
+                             +                             +
+                             +                             +
+                             +                             +
+                             +                             +
+                             +                             +
+                             +                             +
+                             +                             +
+                             +                             +
+                             +                             +
+                             +                             +
+                             +                             +
+++++++++++++++++++++++++++++++++++++++++++++++++++++++++++++