+++++++++++++++++++++++++++++++++++++++++++++++++++++++++++++
+     +                       +                       +     +
+     +                       +                       +     +
++++  +                       +                       +  ++++
+                             +                             +
+                             +                             +
+                             +               Y             +
+                             +                             +
+                             +                             +
+                             +                             +
+                             +                             +
+                             +                             +
+ + + + + + + + + + + + + + + + + + + + + + + + + + + + + + +
+                             +                             +
+                             +                             +
+                             +                             +
+                             +                             +
+                             +                             +
+              X              +                             +
+                             +                             +
+                             +                             +
++++  +                       +                       +  ++++
+     +                       +                       +     +
+     +                       +                       +     +
+++++++++++++++++++++++++++++++++++++++++++++++++++++++++++++